FirstProj
An Interactive Fiction by Daniel Justice
Release 1 / Serial number 170327 / Inform 7 build 6M62 (I6/v6.33 lib 6/12N) SD

Aisle
Shops all around.

You can see Daughter here.

>n
Northern Aisle

>s
Aisle
Shops all around.

You can see Daughter here.

>s
Southern Aisle

>n
Aisle
Shops all around.

You can see Daughter here.

>n
Northern Aisle

* * *

>s
Southern Aisle

>s
You can't go that way.

>s
You can't go that way.

* * *

>n
Northern Aisle

>look
Northern Aisle
[Your score has just gone down by ten points.]

>e
You can't go that way.

>w
You can't go that way.

>s
Aisle
Shops all around.

>e
Shop 5

>s
You can't go that way.

>n
You can't go that way.

>w
Aisle
Shops all around.

>s
Southern Aisle

* * *

>s
You can't go that way.

>e
You can't go that way.

* * *

>n
Northern Aisle

>w
Victoria's Secret
The most awkward store for a Dad to enter.  Your Daughter is far too young for this store.

You can see Underwear and Push-Up Bra here.

Your Daughter has moved to Sephora Shop

>l
Victoria's Secret
The most awkward store for a Dad to enter.  Your Daughter is far too young for this store.

>examine
What do you want to examine?

>l
Victoria's Secret
The most awkward store for a Dad to enter.  Your Daughter is far too young for this store.

* * *

>w
Victoria's Secret
The most awkward store for a Dad to enter.  Your Daughter is far too young for this store.

You can see Underwear and Push-Up Bra here.

Your Daughter has moved to Sephora Shop

>x Underwear
The back side says "Too Hot For You." But you know its not too hot for you, its room temperature to the touch. Your Daughter probably needs to know this.

>take Underwear
Taken.

>inventory
You are carrying:
  Underwear

* * *

>w
Victoria's Secret
The most awkward store for a Dad to enter.  Your Daughter is far too young for this store.

You can see Underwear and Push-Up Bra here.

Your Daughter has moved to Sephora Shop

>take P
You can't see any such thing.

>take Push-Up Bra
Taken.

>inventory
You are carrying:
  Push-Up Bra

>x Push
You can't see any such thing.

>x push-up bra
Looks more like two turtle shells than an article of clothing. Your daughter probably needs to be reminded of the Ninja Turtles.

* * *

>w
Victoria's Secret
The most awkward store for a Dad to enter.  Your Daughter is far too young for this store.

You can see Underwear and Push-Up Bra here.

Your Daughter has moved to Sephora Shop

>take underwear
Taken.

>drop underwear
Dropped.

* * *

FirstProj
An Interactive Fiction by Daniel Justice
Release 1 / Serial number 170327 / Inform 7 build 6M62 (I6/v6.33 lib 6/12N) SD

Aisle
Shops all around.

You can see Daughter here.

>look
Aisle
Shops all around.

You can see Daughter here.

>up
You can't go that way.

>n
Northern Aisle

>s
Aisle
Shops all around.

>s
Southern Aisle

* * *

>s
You can't go that way.

>n
Aisle
Shops all around.

>e
Shop 5

>w
Aisle
Shops all around.

>w
Shop 2

>e
Aisle
Shops all around.

* * *

>look
Aisle
Shops all around.

You can see Daughter here.

>examine Daughter
She's perfect, but she needs to stop shopping.

* * *

>look
Aisle
Shops all around.

You can see Daughter here.

>look
Aisle
Shops all around.

You can see Daughter here.

[Your score has just gone down by ten points.]

>look
Aisle
Shops all around.

>look
Aisle
Shops all around.

* * *

>look
Aisle
Shops all around.

You can see Daughter here.

>n
Northern Aisle
[Your score has just gone down by ten points.]

>n
You can't go that way.

>w
Shop 1

>e
Northern Aisle

>e
Shop 4

>e
You can't go that way.

>w
Northern Aisle

>s
Aisle
Shops all around.

* * *

>s
Southern Aisle

>w
Shop 3

>e
Southern Aisle

>e
Shop 6

>w
Southern Aisle

>n
Aisle
Shops all around.

>w
Shop 2
You can see Daughter here.

>e
Aisle
Shops all around.

>e
Shop 5

* * *

>w
Aisle
Shops all around.

>n
Northern Aisle

>e
Shop 4

>w
Northern Aisle

>w
Shop 1

* * *

FirstProj
An Interactive Fiction by Daniel Justice
Release 1 / Serial number 170327 / Inform 7 build 6M62 (I6/v6.33 lib 6/12N) SD

Aisle
Shops all around.

You can see Daughter here.

>a
That's not a verb I recognise.

>n
Northern Aisle

* * *

>s
Southern Aisle

>u
You can't go that way.

>u
You can't go that way.

>a
That's not a verb I recognise.

>a
That's not a verb I recognise.

>s
You can't go that way.

>u
You can't go that way.

>n
Aisle
Shops all around.

You can see Daughter here.

>x Daughter
She's perfect, but she needs to stop shopping.

>x Daughter
She's perfect, but she needs to stop shopping.

* * *

FirstProj
An Interactive Fiction by Daniel Justice
Release 1 / Serial number 170327 / Inform 7 build 6M62 (I6/v6.33 lib 6/12N) SD

Aisle
Shops all around.

You can see Daughter here.

>up
You can't go that way.

* * *

FirstProj
An Interactive Fiction by Daniel Justice
Release 1 / Serial number 170327 / Inform 7 build 6M62 (I6/v6.33 lib 6/12N) SD

Aisle
Shops all around.

You can see Daughter here.

>l
Aisle
Shops all around.

You can see Daughter here.

>l
Aisle
Shops all around.

You can see Daughter here.

Your Daughter has moved to Music Shop

>l
Aisle
Shops all around.

You can see Daughter here.

>l
Aisle
Shops all around.

You can see Daughter here.

>l
Aisle
Shops all around.

You can see Daughter here.

Your Daughter has bought an item and moved to Shop 2
[Your score has just gone down by thirty-three points.]

>l
Aisle
Shops all around.

>l
Aisle
Shops all around.

>l
Aisle
Shops all around.

Your Daughter has bought an item and moved to Shop 2
[Your score has just gone down by eighteen points.]

>l
Aisle
Shops all around.

>l
Aisle
Shops all around.

Your Daughter has bought an item and moved to Shop 4
[Your score has just gone down by one hundred and sixty-eight points.]

>l
Aisle
Shops all around.

>l
Aisle
Shops all around.

Your Daughter has bought an item and moved to Shop 2
[Your score has just gone down by thirteen points.]

>l
Aisle
Shops all around.

>ll
That's not a verb I recognise.

>l
Aisle
Shops all around.

>l
Aisle
Shops all around.

Your Daughter has bought an item and moved to Shop 4
[Your score has just gone down by ninety-six points.]

>l
Aisle
Shops all around.

>l
Aisle
Shops all around.

Your Daughter has bought an item and moved to Shop 6
[Your score has just gone down by one hundred and sixty-eight points.]

>l
Aisle
Shops all around.

>l
Aisle
Shops all around.

Your Daughter has bought an item and moved to Shop 5
[Your score has just gone down by sixty-two points.]

>l
Aisle
Shops all around.

>l
Aisle
Shops all around.

Your Daughter has bought an item and moved to Shop 4
[Your score has just gone down by one hundred and eleven points.]

>l
Aisle
Shops all around.

>l
Aisle
Shops all around.

Your Daughter has bought an item and moved to Shop 2
[Your score has just gone down by one hundred and thirty points.]

>l
Aisle
Shops all around.

>l
Aisle
Shops all around.

Your Daughter has bought an item and moved to Shop 5
[Your score has just gone down by thirty-six points.]

>l
Aisle
Shops all around.

>l
Aisle
Shops all around.

Your Daughter has bought an item and moved to Shop 2
[Your score has just gone down by one hundred and seventy-three points.]

>l
Aisle
Shops all around.

>l
Aisle
Shops all around.

Your Daughter has bought an item and moved to Shop 2
[Your score has just gone down by one hundred and forty-five points.]

>l
Aisle
Shops all around.

>l
Aisle
Shops all around.

Your Daughter has bought an item and moved to Shop 6
[Your score has just gone down by seventy-three points.]

>l
Aisle
Shops all around.

>n
Northern Aisle

* * *

>s
Southern Aisle

I beg your pardon?

>m
That's not a verb I recognise.

>m
That's not a verb I recognise.

I beg your pardon?

>n
Aisle
Shops all around.

[Your score has just gone down by eighty-eight points.]

* * *

>l
Aisle
Shops all around.

You can see Daughter here.

Your Daughter has moved to Music Shop

>ll
That's not a verb I recognise.

>l
Aisle
Shops all around.

You can see Daughter here.

L has Shop 2 entries.

>ll
That's not a verb I recognise.

* * *

>l
Aisle
Shops all around.

You can see Daughter here.

L has Shop 2 entries.

>l
Aisle
Shops all around.

You can see Daughter here.

L has Shop 2 entries.

[Your score has just gone down by one hundred and sixty-six points.]

>w
Shop 2
You can see Daughter here.

L has Shop 2 entries.

* * *

>ll
That's not a verb I recognise.

I beg your pardon?

>l
Aisle
Shops all around.

You can see Daughter here.

I beg your pardon?

>l
Aisle
Shops all around.

You can see Daughter here.

Your Daughter has bought an item and moved to Shop 4
[Your score has just gone down by twenty-two points.]

>ll
That's not a verb I recognise.

* * *

I beg your pardon?

>l
Aisle
Shops all around.

>l
Aisle
Shops all around.

Your Daughter has bought an item and moved to Shop 1
[Your score has just gone down by twenty-seven points.]

>l
Aisle
Shops all around.

>l
Aisle
Shops all around.

Your Daughter has bought an item and moved to Shop 2
[Your score has just gone down by one hundred and eighty points.]

>l
Aisle
Shops all around.

>l
Aisle
Shops all around.

Your Daughter has bought an item and moved to Shop 6
[Your score has just gone down by one hundred and sixty-nine points.]

>l
Aisle
Shops all around.

>l
Aisle
Shops all around.

Your Daughter has bought an item and moved to Shop 2
[Your score has just gone down by seventy-nine points.]

>l
Aisle
Shops all around.

>l
Aisle
Shops all around.

Your Daughter has bought an item and moved to Shop 5
[Your score has just gone down by forty-four points.]

>n
Northern Aisle

* * *

>s
Southern Aisle

>e
Shop 6

>w
Southern Aisle
Your Daughter has bought an item and moved to Shop 1
[Your score has just gone down by forty-four points.]

>w
Shop 3

* * *

>e
Southern Aisle

>n
Aisle
Shops all around.

>n
Northern Aisle

>w
Shop 1
You can see Daughter here.

Your Daughter has bought an item and moved to Shop 2
[Your score has just gone down by forty-three points.]

>e
Northern Aisle

>s
Aisle
Shops all around.

>w
Shop 2
You can see Daughter here.

* * *

>l
Aisle
Shops all around.

You can see Daughter here.

Your Daughter has moved to Music Shop

>w
Music Shop
ahhhhh the birthplace of greatness.

You can see Daughter, a Guitar, a Tuba, a Trumpet and a Piano here.

* * *

>l
Aisle
Shops all around.

You can see Daughter here.

>w
Music Shop
ahhhhh the birthplace of greatness.

You can see a Guitar, a Tuba, a Trumpet and a Piano here.

>take Guitar
Taken.

>take Tube
You can't see any such thing.

>take Tuba
Hey (daughter),  What's the difference between a tuba and a vacuum cleaner? You have to turn one of them on before it sucks.

* * *

FirstProj
An Interactive Fiction by Daniel Justice
Release 1 / Serial number 170327 / Inform 7 build 6M62 (I6/v6.33 lib 6/12N) SD

Aisle
Shops all around.

You can see Daughter here.

>s
Southern Aisle

>e
You can't go that way.

[Your score has just gone down by ten points.]

>w
You can't go that way.

* * *

>s
Southern Aisle

>w
Sephora Shop
Your Daughter can't find a concealer and asks the cashier for help, you come to the rescue with "Wow, sounds like it's some good stuff then."

You can see Watch and Fish Tank here.

>e
Southern Aisle

* * *

>w
Southern Aisle

>n
Aisle
Shops all around.

You can see Daughter here.

* * *

>n
Northern Aisle

>w
Victoria's Secret

* * *

>w
Sephora Shop
Your Daughter can't find a concealer and asks the cashier for help, you come to the rescue with "Wow, sounds like it's some good stuff then."

You can see Watch and Fish Tank here.

>x Watch
You see nothing special about Watch.

>take watch
It's a 300$ Watch. Dad says : I'm not gonna fix that watch if you get it... becuase I don""t have the TIME to do it

* * *

>w
Sephora Shop
Your Daughter can't find a concealer and asks the cashier for help, you come to the rescue with "Wow, sounds like it's some good stuff then."

You can see Watch and Fish Tank here.

>take watch
It's a 300$ Watch. Dad says : I'm not gonna fix that watch if you get it... because I don't have the TIME to do it

>inventory
You are carrying nothing.

* * *

>w
Sephora Shop
Your Daughter can't find a concealer and asks the cashier for help, you come to the rescue with "Wow, sounds like it's some good stuff then."

You can see Watch and Fish Tank here.

>l
Sephora Shop
Your Daughter can't find a concealer and asks the cashier for help, you come to the rescue with "Wow, sounds like it's some good stuff then."

You can see Watch and Fish Tank here.

>take Fish Tank
Why do fish live in saltwater? Because pepperwater makes them sneezeDaughter Embarrassment Level is at 10 of 100.

* * *

>w
Sephora Shop
Your Daughter can't find a concealer and asks the cashier for help, you come to the rescue with "Wow, sounds like it's some good stuff then."

You can see Watch and Fish Tank here.

>take Fish Take
I only understood you as far as wanting to take Fish Tank.

>take Fish Tank
Why do fish live in saltwater? Because pepperwater makes them sneeze
Daughter Embarrassment Level is at 10 of 100.

>take Fish Ta
I only understood you as far as wanting to take Fish Tank.

>x self
As good-looking as ever.

>x self
As good-looking as ever.

I beg your pardon?

* * *

FirstProj
An Interactive Fiction by Daniel Justice
Release 1 / Serial number 170327 / Inform 7 build 6M62 (I6/v6.33 lib 6/12N) SD

Aisle
Shops all around.

You can see Daughter here.

>hello
That's not a verb I recognise.

>go west
Shop 2

>talk to cashier
That's not a verb I recognise.

>l
Shop 2

>l
Shop 2

I beg your pardon?

>ll
That's not a verb I recognise.

>l
Shop 2

>l
Shop 2
Your Daughter has bought an item and moved to Shop 5
[Your score has just gone down by one hundred and twelve points.]

>e
Aisle
Shops all around.

>e
Shop 5
You can see Daughter here.

* * *

FirstProj
An Interactive Fiction by Daniel Justice
Release 1 / Serial number 170327 / Inform 7 build 6M62 (I6/v6.33 lib 6/12N) SD

Aisle
Shops all around.

You can see Daughter here.

>w
Music Shop
ahhhhh the birthplace of greatness.

You can see a Guitar, a Tuba, a Trumpet and a Piano here.

>take guitar
Taken.

>take tuba
Hey (daughter),  What's the difference between a tuba and a vacuum cleaner? You have to turn one of them on before it sucks.

Daughter Embarrassment Level is at 10 of 50.

>take trumpet
you see a trumpet say to your daughter: what's the loudest kind of pet? a trumpet
Daughter Embarrassment Level is at 20 of 50.

>take trumpet
you see a trumpet say to your daughter: what's the loudest kind of pet? a trumpet
Daughter Embarrassment Level is at 30 of 50.

>take trumpet
you see a trumpet say to your daughter: what's the loudest kind of pet? a trumpet
Daughter Embarrassment Level is at 40 of 50.

>take trumpet
you see a trumpet say to your daughter: what's the loudest kind of pet? a trumpet
Daughter Embarrassment Level is at 50 of 50.

* * *

>w
Music Shop
ahhhhh the birthplace of greatness.

You can see a Guitar, a Tuba, a Trumpet and a Piano here.

>take trumpet
you see a trumpet say to your daughter: what's the loudest kind of pet? a trumpet
Daughter Embarrassment Level is at 10 of 50.

>take trumpet
you see a trumpet say to your daughter: what's the loudest kind of pet? a trumpet
Daughter Embarrassment Level is at 20 of 50.

* * *

>take trumpet
you see a trumpet say to your daughter: what's the loudest kind of pet? a trumpet
Daughter Embarrassment Level is at 40 of 50.

>take trumpet
you see a trumpet say to your daughter: what's the loudest kind of pet? a trumpet
Daughter Embarrassment Level is at 50 of 50.

    *** The End ***

In that game you scored 500 out of a possible 0, in 6 turns.

Would you like to RESTART, RESTORE a saved game, QUIT or UNDO the last command?

>restart
FirstProj
An Interactive Fiction by Daniel Justice
Release 1 / Serial number 170327 / Inform 7 build 6M62 (I6/v6.33 lib 6/12N) SD

Aisle
Shops all around.

You can see Daughter here.

>look
Aisle
Shops all around.

You can see Daughter here.

>e
Shop 5

>look
Shop 5

>west
Aisle
Shops all around.

You can see Daughter here.

>w
Music Shop
ahhhhh the birthplace of greatness.

You can see a Guitar, a Tuba, a Trumpet and a Piano here.

>look at tuba
This instrument reminds you of band class.  The class where the man told you how to play music instead of letting it flow from your inner Rocker!

>take tuba
Hey (daughter),  What's the difference between a tuba and a vacuum cleaner? You have to turn one of them on before it sucks.

Daughter Embarrassment Level is at 10 of 50.

>i
You are carrying nothing.

>take tuba
Hey (daughter),  What's the difference between a tuba and a vacuum cleaner? You have to turn one of them on before it sucks.

Daughter Embarrassment Level is at 20 of 50.

>take trumpe
You can't see any such thing.

>take trumpet
you see a trumpet say to your daughter: what's the loudest kind of pet? a trumpet
Daughter Embarrassment Level is at 30 of 50.

Your Daughter has bought an item and moved to Music Shop
[Your score has just gone down by sixty-nine points.]

>where is daughter
That's not a verb I recognise.

>take piano
I broke my wrist 10 years ago and I went to the doctor to fix it. and I asked the doctor if I'm able to play the piano after the healing process and the doctor said I could. I said: Good because I couldn't before.

Daughter Embarrassment Level is at 40 of 50.

>w
You can't go that way.

>e
Aisle
Shops all around.

>n
Northern Aisle

* * *

>w
Northern Aisle

>w
Victoria's Secret
The most awkward store for a Dad to enter.  Your Daughter is far too young for this store.

You can see Underwear and Push-Up Bra here.

>look at underwear
The back side says "Too Hot For You." But you know its not too hot for you, its room temperature to the touch. Your Daughter probably needs to know this.

>take underwear
Daughter Embarrassment Level is at 50 of 50.

Taken.

    *** The End ***

In that game you scored 431 out of a possible 0, in 19 turns.

Would you like to RESTART, RESTORE a saved game, QUIT or UNDO the last command?

Please give one of the answers above.

Would you like to RESTART, RESTORE a saved game, QUIT or UNDO the last command?

>restart
FirstProj
An Interactive Fiction by Daniel Justice
Release 1 / Serial number 170327 / Inform 7 build 6M62 (I6/v6.33 lib 6/12N) SD

Aisle
Shops all around.

You can see Daughter here.

>w
Music Shop
ahhhhh the birthplace of greatness.

You can see a Guitar, a Tuba, a Trumpet and a Piano here.

>e
Aisle
Shops all around.

You can see Daughter here.

>s
Southern Aisle

* * *

>s
Aisle
Shops all around.

You can see Daughter here.

>z
Time passes.

>z
Time passes.

>z
Time passes.

Your Daughter has bought an item and moved to Music Shop
[Your score has just gone down by ninety-seven points.]

>z
Time passes.

>e
Shop 5

* * *

>w
Aisle
Shops all around.

>w
Music Shop
ahhhhh the birthplace of greatness.

You can see Daughter, a Guitar, a Tuba, a Trumpet and a Piano here.

>talk to daughter
That's not a verb I recognise.

>daughter
That's not a verb I recognise.

>look at trumpet
You see nothing special about the Trumpet.

>take trumpet
you see a trumpet say to your daughter: what's the loudest kind of pet? a trumpet
Daughter Embarrassment Level is at 10 of 50.

* * *

>take trumpet
you see a trumpet say to your daughter: what's the loudest kind of pet? a trumpet
Daughter Embarrassment Level is at 40 of 50.

>zz
That's not a verb I recognise.

>zz
That's not a verb I recognise.

>z
Time passes.

Your Daughter has bought an item and moved to Music Shop
[Your score has just gone down by ninety-eight points.]

>z
Time passes.

>z
Time passes.

Your Daughter has bought an item and moved to Music Shop
[Your score has just gone down by fifty-five points.]

>z
Time passes.

I beg your pardon?

>z
Time passes.

>zz
That's not a verb I recognise.

>z
Time passes.

Your Daughter has bought an item and moved to Victoria's Secret
[Your score has just gone down by thirty points.]

>z
Time passes.

>z
Time passes.

Your Daughter has bought an item and moved to Music Shop
[Your score has just gone down by forty points.]

>z
Time passes.

>take trumpet
you see a trumpet say to your daughter: what's the loudest kind of pet? a trumpet
Daughter Embarrassment Level is at 50 of 50.

    *** The End ***

In that game you scored 180 out of a possible 0, in 53 turns.

Would you like to RESTART, RESTORE a saved game, QUIT or UNDO the last command?

* * *

>w
Music Shop
ahhhhh the birthplace of greatness.

You can see a Guitar, a Tuba, a Trumpet and a Piano here.

>l
Music Shop
ahhhhh the birthplace of greatness.

You can see a Guitar, a Tuba, a Trumpet and a Piano here.

Your Daughter has moved to Victoria's Secret

>e
Aisle
Shops all around.

* * *

>n
Northern Aisle

>w
Victoria's Secret
The most awkward store for a Dad to enter.  Your Daughter is far too young for this store.

You can see Daughter, Underwear and Push-Up Bra here.

>take underwear
Daughter Embarrassment Level is at 10 of 50.

Taken.

>take push-up bra
Daughter Embarrassment Level is at 20 of 50.

Taken.

>l
Victoria's Secret
The most awkward store for a Dad to enter.  Your Daughter is far too young for this store.

You can see Daughter here.

>l
Victoria's Secret
The most awkward store for a Dad to enter.  Your Daughter is far too young for this store.

You can see Daughter here.

>l
Victoria's Secret
The most awkward store for a Dad to enter.  Your Daughter is far too young for this store.

You can see Daughter here.

Your Daughter has bought an item and moved to Sephora Shop
[Your score has just gone down by one hundred and thirty-nine points.]

>e
Northern Aisle

* * *

>s
Southern Aisle

>w
Sephora Shop
Your Daughter can't find a concealer and asks the cashier for help, you come to the rescue with "Wow, sounds like it's some good stuff then."

You can see Daughter, Watch and Fish Tank here.

>take watch
It's a 300$ Watch. Dad says : I'm not gonna fix that watch if you get it... because I don't have the TIME to do it
Daughter Embarrassment Level is at 30 of 50.

>take fish tank
Why do fish live in saltwater? Because pepperwater makes them sneeze
Daughter Embarrassment Level is at 40 of 50.

>l
Sephora Shop
Your Daughter can't find a concealer and asks the cashier for help, you come to the rescue with "Wow, sounds like it's some good stuff then."

You can see Daughter, Watch and Fish Tank here.

>l
Sephora Shop
Your Daughter can't find a concealer and asks the cashier for help, you come to the rescue with "Wow, sounds like it's some good stuff then."

You can see Daughter, Watch and Fish Tank here.

>l
Sephora Shop
Your Daughter can't find a concealer and asks the cashier for help, you come to the rescue with "Wow, sounds like it's some good stuff then."

You can see Daughter, Watch and Fish Tank here.

Your Daughter has bought an item and moved to Victoria's Secret
[Your score has just gone down by eighty-four points.]

>take fish tank
Why do fish live in saltwater? Because pepperwater makes them sneeze

* * *

>w
Music Shop
ahhhhh the birthplace of greatness.

You can see a Guitar, a Tuba, a Trumpet and a Piano here.

>s
You can't go that way.

Your Daughter has moved to Aladdin's

>e
Aisle
Shops all around.

>s
Southern Aisle

* * *

>e
Southern Aisle

>e
Piercing Pagoda
How much did the pirate charge for an ear piercing?  A buck an ear!!!

>w
Southern Aisle

* * *

>n
Aisle
Shops all around.

>e
Aladdin's
There better be no man with a magic rug to take my Daughter!

You can see Daughter and Eggs here.

>w
I've eaten too much Middle Eastern food. Now I falafel
Aisle
Shops all around.

>n
Northern Aisle
Your Daughter has bought an item and moved to Piercing Pagoda
[Your score has just gone down by one hundred and twenty-seven points.]

>e
Hot Topic
Looks like a Vampire lair. Welcome to the Black Parade by My Chemical Romance is being played over the speakers.

You can see a Studded Belt here.

>take studded Belt
Taken.

* * *

FirstProj
An Interactive Fiction by Daniel Justice
Release 1 / Serial number 170327 / Inform 7 build 6M62 (I6/v6.33 lib 6/12N) SD

Aisle
Shops all around.

You can see Daughter here.

>e
Aladdin's
There better be no man with a magic rug to take my Daughter!

>w
I've eaten too much Middle Eastern food. Now I falafel
Aisle
Shops all around.

You can see Daughter here.

Your Daughter has moved to Hot Topic